##########
#O       #
#        #
#        #
#        #
#        #
#       X#
##########