###################
#           # #   #
##### ##### # # # #
#   # #       # # #
# # # # ####### # #
# # # #     #   # #
# # # ##### # ### #
# #   #   #X#   # #
# ##### # ##### # #
# #   # #     # # #
# # # # ##### ### #
#   # # # #   #   #
# ### # # # ### ###
#   #     #      O#
###################