###################
#      O#     #X  #
# ####### ### ### #
# #       # #   # #
# # ####### ### # #
# #   #     #   # #
# ### ### # # ### #
#   #   # # # #   #
# # ### ### ##### #
# #   #   #     # #
# ####### # ### # #
#       # # #   # #
# ##### # # # ### #
#     #     #     #
###################