###################
#   #       #     #
# ### # ### # #####
#   # #   # #   #X#
# # # ### # ### # #
# #   # # #     # #
# ##### # ### ### #
# #O    # #   #   #
# ##### # ##### ###
#     # #   #   # #
##### # ### # ### #
#     #   #   #   #
# ##### # ####### #
#       #         #
###################