###################
#       #   #     #
# ##### # # ### # #
# #O      #   # # #
# ########### # # #
#     #   # #   # #
##### # # # ##### #
#     # #   #     #
# ##### ##### #####
#   # #   #   #   #
### # # # # ##### #
#X  #   #   #   # #
##### ####### # # #
#             #   #
###################