#####################
#         #       # #
# ##### # ### ### # #
#   #   #     #   # #
##### ######### ### #
#   #     # #   #O  #
# # # ### # # ##### #
# # # #   # # #     #
# # ### ### # # ### #
# #     # #     #X# #
# ##### # ####### # #
# #     #   #     # #
# ######### # ##### #
#           #       #
#####################