###################
#       #         #
# ### ### # ##### #
#   #     #   #   #
### ######### # ###
#     #       # # #
####### ####### # #
#X      #       # #
######### ####### #
#   #     #O      #
# # # ######### ###
# # # #       #   #
### # # ##### ### #
#   #   #   #   # #
# ####### ##### # #
#                 #
###################