#############
#     #     #
# ### # # ###
#   # #X#   #
### # ##### #
#   #   #   #
# ####### # #
# #       # #
# # ### ### #
# #  O#   # #
# ####### # #
#         # #
#############