#############
#         # #
# ### ##### #
# # # #   # #
# # # # # # #
# # #   # # #
# # ##### # #
#X    # # # #
##### # # # #
#   #   # # #
# ##### # # #
#   #   #   #
### # #######
#   # #     #
# ### ##### #
#   #       #
# # ####### #
# #    O    #
#############