#######################################
# #     # #   # #   # #   #   # #     #
# # ##### ##### ##### # ####### # #####
# #       #   #   #   #     # # #   # #
# ######### # ### # ### # # # # ### # #
#           #   # # # # # #   #   # # #
############### # # # # # ### ### # # #
#       #     # #   #   #   #   # #   #
# # ### # ##### ##### ##### ### # #####
# #   #   #     #   # # #   # # # #   #
# ### ##### ##### # # # # ### # # # # #
#   #     #   #   #   # # #     #   # #
######### ### ##### ### # # ######### #
#           #     #  O  # # #   #     #
# ### ########### ##### # # # # # ### #
# # # #     #   # # #   # # # # # #   #
# # # # ### # # # # # ### # ### # # ###
# #   # # # # # # #   # # # #   # #   #
# ##### # # # # # # ### # # # # # #####
#       # #   # # #     # # # # #     #
# ####### ##### # ####### # # # #######
#   #         #   #   #   #   # #   # #
# # ##### # ####### # # ####### # # # #
# # #   # #         #   # #   #   #   #
### # # ##### ########### # # ####### #
#X    #       #             #         #
#######################################