#####################
#   #   #  O#       #
# # ### # ### ##### #
# #   # #     #   # #
# ### # # ##### # # #
#   #   #   # # # # #
### ####### # # # # #
#X# #         # #   #
# # # ######### ### #
# # # #     #   #   #
# # ### ### # ### ###
#       #     #     #
#####################