###############################
# #     #   #       #         #
# # ### # # # # ### ### ##### #
# #   #   #   # # #   #   #   #
# ### ######### # ### # # ### #
#             # #   # # #   # #
####### ####### # # # # ### # #
#     # #     # # # # # #   # #
# ### ### ### # # # # # # #####
# #       #     # #   # # #   #
# ####### ####### ####### # # #
# #   #   #   #   #     #   # #
# # # ##### # # ### ### ### # #
#   #     # # #     # #   # # #
# ####### # # ####### ### ### #
#       #   #     #     # #   #
####### ######### # ### # # ###
#     # #       # #   #   #   #
# # ### ##### ### ### ####### #
# #   # #     #   #O# #       #
# ### # # ### # ### # ### ### #
#   # #   #   # #   #   # #   #
### # ##### ### # ##### # # ###
#X  #       #   #         #   #
###############################