#####################################################
#       #   #     #   #           #         #       #
# ##### # ### # ### # # ####### # # # ##### # # #####
#   #   #   # #   # #   #     # #   # #     # # #   #
### # ### # # ### # ##### ### ####### ##### # # # # #
#   # #   #   # #   #   # #         #     #   # # # #
# ### ### ##### ####### # ######### # ### ##### # # #
# # #   # #             # #       # #   #     # # # #
# # ### # # ########### # # ##### # ##### ### ### # #
# # #   #   #     # #   #     #   # #   #  X#     # #
# # ######### ### # # ######### ### # # ####### ### #
# #           #     #     #   # # # # #       # #   #
# ####### ############# ### # # # # # ####### ### # #
#     #   #             #   #   # # #   #   #     # #
##### # ### ############# ####### # ### # ######### #
# #   #           #     #     #   # #   # #         #
# # ##### ######### ### ##### # ### # ### # #########
# #     #   #   #   # #     # #       #       #     #
# ##### ### # # # ### ##### # ############### # ### #
#     # #   # #   #       # #   #           # # # # #
# # # # # ### ####### # # # ### # ######### # # # # #
# # # # # # #       # # # # #   #   #     # # #   # #
# # ### # # ####### # # ### # ##### # # ### ### ### #
# #   # # #       # # #     #     #   # #   #   #   #
# ### # # # ####### # ######### ####### # # # ### # #
#   #   #   #       # #O#       #     # # # #   # # #
### ####### # ####### # # # ### # ### # # ##### # ###
# # #     # # #   #       #   # # # #   #       #   #
# # ##### # # # ### ### ##### ### # ############### #
#   #     # # #       # #   #   #     #             #
# ### ### # # ####### ### # ### # ##### ########### #
#   # # # # # #     #     #   #   #     #   #       #
### # # # # # # ### ######### ##### ##### # # ##### #
# # # #   # #   # # #       #     #     # #   #   # #
# # # ##### ##### # # ### ####### # ### ####### # # #
# # # #     #     # # # #     #   #   #         # # #
# # # # ####### ### # # ##### # ####### ######### ###
#   # # #       #   #       # # #     # # #     #   #
# ### # # ##### # ########### # # ### # # # ### # # #
# #       #   # #     #       # # #   #   # # # # # #
# ######### ### ##### # ####### # # ####### # # ### #
#     #     #     #   # #       # #         #   #   #
##### ### ### ##### ### # ####### ########### ### # #
#   #   #     #   #   # #         #         # #   # #
### ### # ##### # ### # ########### ####### # # # ###
#     # # #     #   # #   #       # #     #   # #   #
# ##### # # ####### # ### # ##### # ### # ######### #
# #   # # # #   #   #   #   #     #   # #   #     # #
# # # # ### # ### ##### # ### ####### ### # # ### # #
#   #       #           #   #             #   #     #
#####################################################